11111
11101
1P001
1E001
1C001
11111